#####......................................#
..#........................................#
..#........................................#
..#......###...............................#
..#.....#...#..............................#
........#####..............................#
........#...#...#...#......................#
........#...#...##..#......................#
................#.# #......................#
................#..##...#...#..............#
................#...#...#..#...............#
........................###................#
........................#..#.....####......#
........................#...#...#..........#
.................................###.......#
....................................#...#..#
................................####....#..#
........................................#..#
...........................................#
........................................#..#
