............................................
#.........##.....#.........................#
#........#..#..............................#
#.........##...............................#
#..................#.......................#
#.........#........##.............#........#
#....#.........#....#............#.........#
#....#.....................................#
#............#.............#..........#....#
#.........##.....#......................#..#
#........#..#..............................#
#.........##..................#............#
#..........................................#
#....#..............#...........#..........#
#....................#...##...#............#
#..........##..........#....#.........#....#
#.........#...#........#....#..............#
#.........#...#......#...##...#............#
#..........##......#............#.......#..#
............................................
