######......####################......######
#..........................................#
#.....#####......................#####.....#
#..........#....................#..........#
#...........#####..........#####...........#
#..........................................#
#.........##....................##.........#
#............#..#..........#..#............#
#..............#............#..............#
#.............#..............#.............#
#....................##....................#
#....................##....................#
#....................##....................#
#.............#......##......#.............#
#...........#..#............#..#...........#
#.........#.....#..........#.....#.........#
#.......#............##............#.......#
#........#........................#........#
#..........................................#
######......####################......######
