#######.##########################.#########
#...................##.....................#
#...................##.....................#
#.....####......................####.......#
#..........................................#
#............###...........###.............#
#............#...............#.............#
#...##.......#....#....#.....#......##.....#
#....#..............................#......#
.....#...#......................#...#.......
.....#...#......................#...#.......
#....#..............................#......#
#...##.......#....#....#.....#......##.....#
#............#...............#.............#
#............###...........###.............#
#..........................................#
#.....####......................####.......#
#...................##.....................#
#...................##.....................#
#######.##########################.#########
